Source: @SNAP@gnome-utils
Section: utils
Priority: optional
Maintainer: James LewisMoss <dres@debian.org>
Standards-Version: 3.0.0

Package: @SNAP@gnome-utils
Architecture: any
Depends: @SNAP@gnome-core (>= 1.0.7-0), ${shlibs:Depends}
Description: Gnome Utilities (gtt, ghex, and more)
 Gnome is the "GNU Network Object Model Environment"
 .
 It is a project to build a complete, user-friendly desktop based
 entirely on free software.
 .
 This package contains:
 .
   gcalc - a simple calculator
   gcolorsel - a color selector
   gdialog - a Gtk version of the 'dialog' program
   gfontsel - a font selector
   ghex - a hex editor
   gless - a Gtk version of the 'less' pager
   gnome-run - a graphical utility to execute a user entered command
   gpenguin - a penguin that follows the mouse
   grun - a minimal graphical utility to execute a user entered command
   gsearchtool - a tool for finding and grepping through files
   gshutdown - reboot or shutdown your machine
   gstripchart - plot system measurements
   gtt - a task timer/tracker
   guname - display 'uname' information about your system
   gw - display users on the system, like 'w'
   idetool - an IDE disk viewing tool
   splash/splac - splash screen renderer
